**********
*P       *
*        *
*        *
*    M   *
***      *
*        *
*      ***
*       G*
**********